dateTime,luminosity,ir,full,visible,lux
2022-03-25 19:09:32.364880,1796992457,27419,60873,33454,1000.162000
2022-03-25 19:09:42.358817,1796730288,27415,60848,33433,999.317080
2022-03-25 19:09:52.368349,1798106605,27436,60909,33473,1000.706500
2022-03-25 19:10:02.362917,1799089685,27451,60949,33498,1001.544100
2022-03-25 19:10:12.371910,1799286285,27454,60941,33487,1001.017800
2022-03-25 19:10:22.381182,1798237680,27438,60912,33474,1000.717000
2022-03-25 19:10:32.375274,1796992442,27419,60858,33439,999.511470
2022-03-25 19:10:42.384623,1797713363,27430,60883,33453,999.937870
2022-03-25 19:10:52.394288,1796992442,27419,60858,33439,999.511470
2022-03-25 19:11:02.403943,1798106589,27436,60893,33457,1000.012800
2022-03-25 19:11:12.398166,1797844436,27432,60884,33452,999.861570
2022-03-25 19:11:22.407820,1794895226,27387,60794,33407,998.649600
2022-03-25 19:11:32.417032,1793649965,27368,60717,33349,996.447020
2022-03-25 19:11:42.411099,1793322285,27363,60717,33354,996.745910
2022-03-25 19:11:52.420494,1793060125,27359,60701,33342,996.291380
2022-03-25 19:12:02.430301,1793518890,27366,60714,33348,996.436520
2022-03-25 19:12:12.424167,1793256754,27362,60722,33360,997.022400
2022-03-25 19:12:22.433709,1793846617,27371,60761,33390,998.175420
2022-03-25 19:12:32.443215,1794108770,27375,60770,33395,998.326420
2022-03-25 19:12:42.437724,1794895229,27387,60797,33410,998.779790
2022-03-25 19:12:52.446765,1795812757,27401,60821,33420,998.983340
2022-03-25 19:13:02.456962,1798041078,27435,60918,33483,1001.156600
2022-03-25 19:13:12.466129,1797516762,27427,60890,33463,1000.420700
2022-03-25 19:13:22.460245,1798106622,27436,60926,33490,1001.443700
2022-03-25 19:13:32.469776,1798827544,27447,60952,33505,1001.913400
2022-03-25 19:13:42.479290,1797975536,27434,60912,33478,1000.956100
2022-03-25 19:13:52.473411,1798303232,27439,60928,33489,1001.351000
2022-03-25 19:14:02.482938,1798106607,27436,60911,33475,1000.793200
2022-03-25 19:14:12.492477,1798368778,27440,60938,33498,1001.724800
2022-03-25 19:14:22.502176,1797385711,27425,60911,33486,1001.451100
2022-03-25 19:14:32.511519,1800466009,27472,61017,33545,1003.237200
2022-03-25 19:14:42.521239,1798565406,27443,60958,33515,1002.413000
2022-03-25 19:14:52.515545,1794108802,27375,60802,33427,999.714110
2022-03-25 19:15:02.525027,1794370942,27379,60798,33419,999.301570
2022-03-25 19:15:12.534643,1793846663,27371,60807,33436,1000.170300
2022-03-25 19:15:22.544108,1795550646,27397,60854,33457,1000.653700
2022-03-25 19:15:32.538240,1798106647,27436,60951,33515,1002.528000
2022-03-25 19:15:42.547558,1799155258,27452,60986,33534,1003.089100
2022-03-25 19:15:52.541521,1797123578,27421,60922,33501,1002.167400
2022-03-25 19:16:02.551214,1799745088,27461,60992,33531,1002.810800
2022-03-25 19:16:12.544955,1804922598,27540,61158,33618,1005.285500
2022-03-25 19:16:22.554444,1801973401,27495,61081,33586,1004.637300
2022-03-25 19:16:32.563879,1800531574,27473,61046,33573,1004.435200
2022-03-25 19:16:42.557953,1800138345,27467,61033,33566,1004.230400
2022-03-25 19:16:52.567545,1799941736,27464,61032,33568,1004.366600
2022-03-25 19:17:02.577114,1800466034,27472,61042,33570,1004.321700
2022-03-25 19:17:12.586558,1799614031,27459,61007,33548,1003.581200
2022-03-25 19:17:22.580654,1799286353,27454,61009,33555,1003.967100
2022-03-25 19:17:32.590082,1800269423,27469,61039,33570,1004.371000
2022-03-25 19:17:42.599556,1802628787,27505,61107,33602,1005.167000
2022-03-25 19:17:52.593704,1804201705,27529,61161,33632,1006.073500
2022-03-25 19:18:02.603424,1802890993,27509,61169,33660,1007.617600
2022-03-25 19:18:12.612733,1802235623,27499,61159,33660,1007.782300
2022-03-25 19:18:22.622249,1803480853,27518,61205,33687,1008.641100
2022-03-25 19:18:32.616434,1803415325,27517,61213,33696,1009.048300
2022-03-25 19:18:42.625877,1804988240,27541,61264,33723,1009.824600
2022-03-25 19:18:52.635370,1807544237,27580,61357,33777,1011.525700
2022-03-25 19:19:02.644920,1805512553,27549,61289,33740,1010.430600
2022-03-25 19:19:12.639044,1803022122,27511,61226,33715,1009.972100
2022-03-25 19:19:22.648614,1806299020,27561,61324,33763,1011.231300
2022-03-25 19:19:32.658139,1806561177,27565,61337,33772,1011.556100
2022-03-25 19:19:42.652448,1808723933,27598,61405,33807,1012.531200
2022-03-25 19:19:52.662086,1808855026,27600,61426,33826,1013.323100
2022-03-25 19:20:02.671481,1809248274,27606,61458,33852,1014.353100
2022-03-25 19:20:12.680867,1809969182,27617,61470,33853,1014.214900
2022-03-25 19:20:22.674970,1810296884,27622,61492,33870,1014.870500
2022-03-25 19:20:32.684373,1810165822,27620,61502,33882,1015.424800
2022-03-25 19:20:42.693824,1811935341,27647,61549,33902,1015.847700
2022-03-25 19:20:52.687980,1813311667,27668,61619,33951,1017.628800
2022-03-25 19:21:02.697591,1814687985,27689,61681,33992,1019.062800
2022-03-25 19:21:12.707192,1815146737,27696,61681,33985,1018.643100
2022-03-25 19:21:22.717099,1814425821,27685,61661,33976,1018.433800
2022-03-25 19:21:32.726551,1814032583,27679,61639,33960,1017.838000
2022-03-25 19:21:42.736042,1816457497,27716,61721,34005,1019.181500
2022-03-25 19:21:52.745765,1817702734,27735,61774,34039,1020.344200
2022-03-25 19:22:02.739789,1817440580,27731,61764,34033,1020.149900
2022-03-25 19:22:12.749076,1817571643,27733,61755,34022,1019.639000
2022-03-25 19:22:22.758743,1819341202,27760,61842,34082,1021.799100
2022-03-25 19:22:32.752701,1818816883,27752,61811,34059,1020.932300
2022-03-25 19:22:42.762192,1819865522,27768,61874,34106,1022.709400
2022-03-25 19:22:52.771872,1817637208,27734,61784,34050,1020.838600
2022-03-25 19:23:02.781512,1812132010,27650,61610,33960,1018.317100
2022-03-25 19:23:12.790935,1808920647,27601,61511,33910,1016.954900
2022-03-25 19:23:22.800559,1813967121,27678,61713,34035,1021.112900
2022-03-25 19:23:32.794695,1813442800,27670,61680,34010,1020.158900
2022-03-25 19:23:42.804196,1812852970,27661,61674,34013,1020.438000
2022-03-25 19:23:52.813712,1813180658,27666,61682,34016,1020.485700
2022-03-25 19:24:02.823301,1816326492,27714,61788,34074,1022.212200
2022-03-25 19:24:12.817235,1817506188,27732,61836,34104,1023.218000
2022-03-25 19:24:22.826895,1817702802,27735,61842,34107,1023.298600
2022-03-25 19:24:32.836215,1819800064,27767,61952,34185,1026.159200
2022-03-25 19:24:42.830292,1817637268,27734,61844,34110,1023.445700
2022-03-25 19:24:52.839783,1819210204,27758,61916,34158,1025.134600
2022-03-25 19:25:02.849382,1821504035,27793,61987,34194,1026.119900
2022-03-25 19:25:12.858881,1817768361,27736,61865,34129,1024.238300
2022-03-25 19:25:22.852967,1814163794,27681,61778,34097,1023.758200
2022-03-25 19:25:32.862477,1814098264,27680,61784,34104,1024.079100
2022-03-25 19:25:42.872165,1815146865,27696,61809,34113,1024.205300
2022-03-25 19:25:52.881723,1812787471,27660,61711,34051,1022.106200
2022-03-25 19:26:02.875781,1814819179,27691,61803,34112,1024.244800
2022-03-25 19:26:12.885043,1814491465,27686,61769,34083,1023.066800
2022-03-25 19:26:22.894601,1817178555,27727,61883,34156,1025.561200
2022-03-25 19:26:32.904143,1817506237,27732,61885,34153,1025.347800
2022-03-25 19:26:42.898197,1819210243,27758,61955,34197,1026.830000
2022-03-25 19:26:52.907639,1819931193,27769,62009,34240,1028.517600
2022-03-25 19:27:02.917164,1821045330,27786,62034,34248,1028.583400
2022-03-25 19:27:12.926736,1823470272,27823,62144,34321,1031.144500
2022-03-25 19:27:22.920820,1824781030,27843,62182,34339,1031.595600
2022-03-25 19:27:32.930274,1824060119,27832,62167,34335,1031.604200
2022-03-25 19:27:42.939915,1823208106,27819,62122,34303,1030.428000
2022-03-25 19:27:52.933946,1823077034,27817,62122,34305,1030.548300
2022-03-25 19:28:02.943510,1823535809,27824,62145,34321,1031.128100
2022-03-25 19:28:12.952738,1823077023,27817,62111,34294,1030.069800
2022-03-25 19:28:22.962436,1824846574,27844,62190,34346,1031.883500
2022-03-25 19:28:32.972065,1824518877,27839,62173,34334,1031.444500
2022-03-25 19:28:42.966215,1823077037,27817,62125,34308,1030.678700
2022-03-25 19:28:52.975729,1824846579,27844,62195,34351,1032.101100
2022-03-25 19:29:02.985443,1825567502,27855,62222,34367,1032.614400
2022-03-25 19:29:12.995044,1826485041,27869,62257,34388,1033.295500
2022-03-25 19:29:22.989042,1826419510,27868,62262,34394,1033.573100
2022-03-25 19:29:32.998920,1827861376,27890,62336,34446,1035.470000
2022-03-25 19:29:43.008240,1827337052,27882,62300,34418,1034.384900
2022-03-25 19:29:53.017852,1828778919,27904,62375,34471,1036.325300
2022-03-25 19:30:03.027376,1831662610,27948,62482,34534,1038.335600
2022-03-25 19:30:13.036882,1830089699,27924,62435,34511,1037.733500
2022-03-25 19:30:23.031031,1830286319,27927,62447,34520,1038.075300
2022-03-25 19:30:33.040427,1831465999,27945,62479,34534,1038.385500
2022-03-25 19:30:43.049924,1831007257,27938,62489,34551,1039.241700
2022-03-25 19:30:53.044043,1831072806,27939,62502,34563,1039.747400
2022-03-25 19:31:03.053719,1832055844,27954,62500,34546,1038.758200
2022-03-25 19:31:13.063108,1832842308,27966,62532,34566,1039.429100
2022-03-25 19:31:23.072770,1833235555,27972,62563,34591,1040.417200
2022-03-25 19:31:33.066827,1834546337,27992,62625,34633,1041.912800
2022-03-25 19:31:43.076210,1835726015,28010,62655,34645,1042.135900
2022-03-25 19:31:53.085865,1836250320,28018,62672,34654,1042.394400
2022-03-25 19:32:03.095911,1836643546,28024,62682,34658,1042.468800
2022-03-25 19:32:13.104918,1838806322,28057,62770,34713,1044.313800
2022-03-25 19:32:23.114470,1839723850,28071,62794,34723,1044.516400
2022-03-25 19:32:33.108567,1841821117,28103,62909,34806,1047.597200
2022-03-25 19:32:43.118116,1852569440,28267,63328,35061,1055.970300
2022-03-25 19:32:53.127464,1845163574,28154,63030,34876,1049.796000
2022-03-25 19:33:03.121516,1840838055,28088,62887,34799,1047.542200
2022-03-25 19:33:13.131003,1840182625,28078,62817,34739,1045.096300
2022-03-25 19:33:23.140283,1840117134,28077,62862,34785,1047.115800
2022-03-25 19:33:33.134440,1839920515,28074,62851,34777,1046.817400
2022-03-25 19:33:43.144120,1840903618,28089,62914,34825,1048.658100
2022-03-25 19:33:53.153534,1840641439,28085,62879,34794,1047.374500
2022-03-25 19:34:03.163081,1837954360,28044,62776,34732,1045.357500
2022-03-25 19:34:13.157087,1837036804,28030,62724,34694,1043.936200
2022-03-25 19:34:23.166583,1840379296,28081,62880,34799,1047.658900
2022-03-25 19:34:33.175975,1840182644,28078,62836,34758,1045.923500
2022-03-25 19:34:43.185603,1841427886,28097,62894,34797,1047.305300
2022-03-25 19:34:53.179636,1841493428,28098,62900,34802,1047.506500
2022-03-25 19:35:03.189452,1842148820,28108,62932,34824,1048.297700
2022-03-25 19:35:13.199129,1846670990,28177,63118,34941,1052.243700
2022-03-25 19:35:23.208497,1845163596,28154,63052,34898,1050.754200
2022-03-25 19:35:33.218068,1846212235,28170,63115,34945,1052.534500
2022-03-25 19:35:43.212220,1843721758,28132,63006,34874,1050.075400
2022-03-25 19:35:53.221806,1845098075,28153,63067,34914,1051.467800
2022-03-25 19:36:03.231116,1849095931,28214,63227,35013,1054.763200
2022-03-25 19:36:13.240531,1845687925,28162,63093,34931,1052.058200
2022-03-25 19:36:23.234634,1841886696,28104,62952,34848,1049.409700
2022-03-25 19:36:33.244347,1843459607,28128,62999,34871,1050.011500
2022-03-25 19:36:43.253617,1840838066,28088,62898,34810,1048.021200
2022-03-25 19:36:53.263110,1840379307,28081,62891,34810,1048.137900
2022-03-25 19:37:03.257168,1841165771,28093,62923,34830,1048.809100
2022-03-25 19:37:13.266776,1847850679,28195,63159,34964,1052.945400
2022-03-25 19:37:23.276150,1839199624,28063,62856,34793,1047.697600
2022-03-25 19:37:33.270189,1840051570,28076,62834,34758,1045.956900
2022-03-25 19:37:43.279637,1840444776,28082,62824,34742,1045.160400
2022-03-25 19:37:53.289230,1839855007,28073,62879,34806,1048.097000
2022-03-25 19:38:03.298712,1841558990,28099,62926,34827,1048.578500
2022-03-25 19:38:13.292864,1839199584,28063,62816,34753,1045.955600
2022-03-25 19:38:23.302107,1838282057,28049,62793,34744,1045.796800
2022-03-25 19:38:33.311552,1838806389,28057,62837,34780,1047.231200
2022-03-25 19:38:43.305698,1839199581,28063,62813,34750,1045.825000
2022-03-25 19:38:53.315150,1837233455,28033,62767,34734,1045.627800
2022-03-25 19:39:03.324808,1837102356,28031,62740,34709,1044.572500
2022-03-25 19:39:13.334348,1834742995,27995,62675,34680,1043.909200
2022-03-25 19:39:23.343731,1834284214,27988,62646,34658,1043.067900
2022-03-25 19:39:33.353323,1834349765,27989,62661,34672,1043.660800
2022-03-25 19:39:43.347344,1832580230,27962,62598,34636,1042.542700
2022-03-25 19:39:53.357030,1833366683,27974,62619,34645,1042.734900
2022-03-25 19:40:03.367234,1834546361,27992,62649,34657,1042.957800
2022-03-25 19:40:13.376038,1834546360,27992,62648,34656,1042.914200
2022-03-25 19:40:23.385713,1834611906,27993,62658,34665,1043.289300
2022-03-25 19:40:33.395219,1834677454,27994,62670,34676,1043.751700
2022-03-25 19:40:43.389474,1834153139,27986,62643,34657,1043.057500
2022-03-25 19:40:53.398733,1834677467,27994,62683,34689,1044.317700
2022-03-25 19:41:03.408140,1834415298,27990,62658,34668,1043.470000
2022-03-25 19:41:13.402217,1833104533,27970,62613,34643,1042.714400
2022-03-25 19:41:23.411755,1837298995,28034,62771,34737,1045.741900
2022-03-25 19:41:33.421277,1830548530,27931,62514,34583,1040.751200
2022-03-25 19:41:43.430875,1829237784,27911,62488,34577,1040.823000
2022-03-25 19:41:53.424915,1831269467,27942,62555,34613,1041.874400
2022-03-25 19:42:03.434832,1831203936,27941,62560,34619,1042.152200
2022-03-25 19:42:13.444006,1830089764,27924,62500,34576,1040.563000
2022-03-25 19:42:23.453533,1837298993,28034,62769,34735,1045.654500
2022-03-25 19:42:33.447495,1827402681,27883,62393,34510,1038.371900
2022-03-25 19:42:43.456989,1828647919,27902,62447,34545,1039.579600
2022-03-25 19:42:53.466654,1828582388,27901,62452,34551,1039.857400
2022-03-25 19:43:03.476074,1828910080,27906,62464,34558,1040.079000
2022-03-25 19:43:13.485616,1827402690,27883,62402,34519,1038.763900
2022-03-25 19:43:23.479805,1828975631,27907,62479,34572,1040.671900
2022-03-25 19:43:33.489194,1826419604,27868,62356,34488,1037.663700
2022-03-25 19:43:43.498898,1831859329,27951,62593,34642,1042.987300
2022-03-25 19:43:53.508441,1829172243,27910,62483,34573,1040.665500
2022-03-25 19:44:03.518012,1827140530,27879,62386,34507,1038.307900
2022-03-25 19:44:13.512110,1826878374,27875,62374,34499,1038.026100
2022-03-25 19:44:23.521768,1827861484,27890,62444,34554,1040.171300
2022-03-25 19:44:33.531078,1826747299,27873,62371,34498,1038.016000
2022-03-25 19:44:43.525034,1827140534,27879,62390,34511,1038.482200
2022-03-25 19:44:53.534596,1827140527,27879,62383,34504,1038.177200
2022-03-25 19:45:03.544011,1826222999,27865,62359,34494,1037.975000
2022-03-25 19:45:13.553550,1825305452,27851,62316,34465,1036.945400
2022-03-25 19:45:23.563246,1825764233,27858,62345,34487,1037.786700
2022-03-25 19:45:33.557387,1825436546,27853,62338,34485,1037.782800
2022-03-25 19:45:43.566967,1826485154,27869,62370,34501,1038.213300
2022-03-25 19:45:53.576346,1827992538,27892,62426,34534,1039.267100
2022-03-25 19:46:03.570784,1827533781,27885,62421,34536,1039.470700
2022-03-25 19:46:13.580076,1825371002,27852,62330,34478,1037.494800
2022-03-25 19:46:23.589288,1826681756,27872,62364,34492,1037.771400
2022-03-25 19:46:33.598857,1826616205,27871,62349,34478,1037.178600
2022-03-25 19:46:43.608468,1827992548,27892,62436,34544,1039.702600
2022-03-25 19:46:53.602554,1828647937,27902,62465,34563,1040.363300
2022-03-25 19:47:03.612182,1827009462,27877,62390,34513,1038.602400
2022-03-25 19:47:13.621682,1828975630,27907,62478,34571,1040.628400
2022-03-25 19:47:23.631271,1828516850,27900,62450,34550,1039.830600
2022-03-25 19:47:33.625444,1828320237,27897,62445,34548,1039.793300
2022-03-25 19:47:43.634871,1828058089,27893,62441,34548,1039.860000
2022-03-25 19:47:53.644444,1827402710,27883,62422,34539,1039.634600
2022-03-25 19:48:03.653932,1828451332,27899,62468,34569,1040.674600
2022-03-25 19:48:13.663499,1828582437,27901,62501,34600,1041.991500
2022-03-25 19:48:23.657502,1828254719,27896,62463,34567,1040.637500
2022-03-25 19:48:33.666990,1828058098,27893,62450,34557,1040.252000
2022-03-25 19:48:43.676585,1827075014,27878,62406,34528,1039.238900
2022-03-25 19:48:53.670704,1827927040,27891,62464,34573,1040.982100
2022-03-25 19:49:03.680231,1828058125,27893,62477,34584,1041.427900
2022-03-25 19:49:13.689642,1827533810,27885,62450,34565,1040.733600
2022-03-25 19:49:23.699259,1830220891,27926,62555,34629,1042.837800
2022-03-25 19:49:33.693375,1830417511,27929,62567,34638,1043.179800
2022-03-25 19:49:43.702824,1828582444,27901,62508,34607,1042.296400
2022-03-25 19:49:53.712327,1827075052,27878,62444,34566,1040.893800
2022-03-25 19:50:03.706453,1826091957,27863,62389,34526,1039.401700
2022-03-25 19:50:13.716324,1827009508,27877,62436,34559,1040.605600
2022-03-25 19:50:23.725836,1828189209,27895,62489,34594,1041.830100
2022-03-25 19:50:33.735345,1828320289,27897,62497,34600,1042.058000
2022-03-25 19:50:43.745118,1829434453,27914,62549,34635,1043.299200
2022-03-25 19:50:53.754490,1828713525,27903,62517,34614,1042.567900
2022-03-25 19:51:03.763907,1830089836,27924,62572,34648,1043.698900
2022-03-25 19:51:13.773644,1830614146,27932,62594,34662,1044.175400
2022-03-25 19:51:23.783278,1831138460,27940,62620,34680,1044.826200
2022-03-25 19:51:33.792856,1831793836,27950,62636,34686,1044.920800
2022-03-25 19:51:43.787339,1832252628,27957,62676,34719,1046.241700
2022-03-25 19:51:53.796517,1833563383,27977,62711,34734,1046.561500
2022-03-25 19:52:03.805956,1834546465,27992,62753,34761,1047.487700
2022-03-25 19:52:13.799955,1836840279,28027,62807,34780,1047.731400
2022-03-25 19:52:23.809341,1836119374,28016,62798,34782,1048.002200
2022-03-25 19:52:33.803338,1835857216,28012,62784,34772,1047.633300
2022-03-25 19:52:43.812780,1836578168,28023,62840,34817,1049.410600
2022-03-25 19:52:53.822453,1837102468,28031,62852,34821,1049.451200
2022-03-25 19:53:03.816470,1838937556,28059,62932,34873,1051.250000
2022-03-25 19:53:13.825924,1838478789,28052,62917,34865,1051.018200
2022-03-25 19:53:23.835547,1837430186,28036,62890,34854,1050.806200
2022-03-25 19:53:33.845052,1837757869,28041,62893,34852,1050.635300
2022-03-25 19:53:43.839151,1837102501,28031,62885,34854,1050.889600
2022-03-25 19:53:53.848737,1838806486,28057,62934,34877,1051.457600
2022-03-25 19:54:03.858356,1838806501,28057,62949,34892,1052.111600
2022-03-25 19:54:13.867772,1839003115,28060,62955,34895,1052.192100
2022-03-25 19:54:23.862144,1839003114,28060,62954,34894,1052.148600
2022-03-25 19:54:33.871740,1839461883,28067,62971,34904,1052.467500
2022-03-25 19:54:43.880992,1839199738,28063,62970,34907,1052.665200
2022-03-25 19:54:53.890337,1839592981,28069,62997,34928,1053.480300
2022-03-25 19:55:03.884817,1840510533,28083,63045,34962,1054.728800
2022-03-25 19:55:13.893920,1841296996,28095,63076,34981,1055.356600
2022-03-25 19:55:23.903606,1841886822,28104,63078,34974,1054.900600
2022-03-25 19:55:33.897887,1842673268,28116,63092,34976,1054.787200
2022-03-25 19:55:43.907010,1842017911,28106,63095,34989,1055.521400
2022-03-25 19:55:53.916693,1842214528,28109,63104,34995,1055.732800
2022-03-25 19:56:03.926292,1843328677,28126,63141,35015,1056.320600
2022-03-25 19:56:13.935560,1843197611,28124,63147,35023,1056.702800
2022-03-25 19:56:23.929739,1842935469,28120,63149,35029,1057.031400
2022-03-25 19:56:33.939157,1843197608,28124,63144,35020,1056.572000
2022-03-25 19:56:43.948653,1843132093,28123,63165,35042,1057.548200
2022-03-25 19:56:53.958188,1844180698,28139,63194,35055,1057.847400
2022-03-25 19:57:03.952281,1844180717,28139,63213,35074,1058.676000
2022-03-25 19:57:13.962007,1844442878,28143,63230,35087,1059.176100
2022-03-25 19:57:23.971325,1845950242,28166,63266,35100,1059.358000
2022-03-25 19:57:33.981061,1846474564,28174,63300,35126,1060.358200
2022-03-25 19:57:43.990649,1846212416,28170,63296,35126,1060.425300
2022-03-25 19:57:54.000232,1848768428,28209,63404,35195,1062.782000
2022-03-25 19:58:03.994917,1849489350,28220,63430,35210,1063.252100
2022-03-25 19:58:14.003778,1849161672,28215,63432,35217,1063.641400
2022-03-25 19:58:24.013235,1849751524,28224,63460,35236,1064.319700
2022-03-25 19:58:34.022759,1851062280,28244,63496,35252,1064.682400
2022-03-25 19:58:44.016902,1850079233,28229,63489,35260,1065.283000
2022-03-25 19:58:54.026323,1849882605,28226,63469,35243,1064.591400
2022-03-25 19:59:04.035718,1855322300,28309,63676,35367,1068.610800
2022-03-25 19:59:14.029933,1861613991,28405,63911,35506,1073.066800
2022-03-25 19:59:24.039482,1850996800,28243,63552,35309,1067.187000
2022-03-25 19:59:34.048864,1846671260,28177,63388,35211,1064.017100
2022-03-25 19:59:44.042865,1855846613,28317,63701,35384,1069.218600
2022-03-25 19:59:54.052360,1853028463,28274,63599,35325,1067.365000
2022-03-25 20:00:04.061905,1845753700,28163,63332,35169,1062.418700
2022-03-25 20:00:14.071153,1845557086,28160,63326,35166,1062.338100
2022-03-25 20:00:24.065314,1844836169,28149,63305,35156,1062.086300
2022-03-25 20:00:34.075121,1843197716,28124,63252,35128,1061.283700
2022-03-25 20:00:44.084224,1843001087,28121,63231,35110,1060.548500
2022-03-25 20:00:54.093880,1843066622,28122,63230,35108,1060.444300
2022-03-25 20:01:04.087836,1844442923,28143,63275,35132,1061.139500
2022-03-25 20:01:14.097415,1842870022,28119,63238,35119,1060.974700
2022-03-25 20:01:24.106892,1845229402,28155,63322,35167,1062.465800
2022-03-25 20:01:34.116396,1846736786,28178,63378,35200,1063.520000
2022-03-25 20:01:44.125956,1842804498,28118,63250,35132,1061.559000
2022-03-25 20:01:54.120117,1841886965,28104,63221,35117,1061.139200
2022-03-25 20:02:04.129635,1841493707,28098,63179,35081,1059.668700
2022-03-25 20:02:14.139170,1845426013,28158,63325,35167,1062.415300
2022-03-25 20:02:24.148644,1843853096,28134,63272,35138,1061.552400
2022-03-25 20:02:34.158302,1845163870,28154,63326,35172,1062.700700
2022-03-25 20:02:44.167983,1846409114,28173,63386,35213,1064.171400
2022-03-25 20:02:54.177506,1854798042,28301,63706,35405,1070.404100
2022-03-25 20:03:04.171553,1845884791,28165,63351,35186,1063.127200
2022-03-25 20:03:14.181083,1844377407,28142,63295,35153,1062.072900
2022-03-25 20:03:24.190520,1842738956,28117,63244,35127,1061.357500
2022-03-25 20:03:34.184440,1840182959,28078,63151,35073,1059.654900
2022-03-25 20:03:44.194045,1839855275,28073,63147,35074,1059.782500
2022-03-25 20:03:54.203560,1840510661,28083,63173,35090,1060.313100
2022-03-25 20:04:04.197532,1839593143,28069,63159,35090,1060.548100
2022-03-25 20:04:14.206990,1840182985,28078,63177,35099,1060.789900
2022-03-25 20:04:24.216520,1840314075,28080,63195,35115,1061.455000
2022-03-25 20:04:34.225996,1840641748,28085,63188,35103,1060.846900
2022-03-25 20:04:44.235814,1840248538,28079,63194,35115,1061.471600
2022-03-25 20:04:54.245319,1840969460,28090,63220,35130,1061.941900
2022-03-25 20:05:04.239352,1840510693,28083,63205,35122,1061.710100
2022-03-25 20:05:14.249051,1840117472,28077,63200,35123,1061.854600
2022-03-25 20:05:24.258582,1839331008,28065,63168,35103,1061.183000
2022-03-25 20:05:34.268127,1840969478,28090,63238,35148,1062.727800
2022-03-25 20:05:44.277637,1837889179,28043,63131,35088,1060.897700
2022-03-25 20:05:54.271706,1841100565,28092,63253,35161,1063.261800
2022-03-25 20:06:04.281260,1841297165,28095,63245,35150,1062.731000
2022-03-25 20:06:14.290633,1842083631,28107,63279,35172,1063.490000
2022-03-25 20:06:24.300118,1840969512,28090,63272,35182,1064.212500
2022-03-25 20:06:34.294215,1841297181,28095,63261,35166,1063.429700
2022-03-25 20:06:44.303674,1841952575,28105,63295,35190,1064.309700
2022-03-25 20:06:54.313259,1842607977,28115,63337,35222,1065.539300
2022-03-25 20:07:04.322767,1842870143,28119,63359,35240,1066.258200
2022-03-25 20:07:14.316906,1843918735,28135,63375,35240,1065.988900
2022-03-25 20:07:24.326451,1844639665,28146,63409,35263,1066.808700
2022-03-25 20:07:34.336000,1844836273,28149,63409,35260,1066.627100
2022-03-25 20:07:44.345457,1844574131,28145,63411,35266,1066.956500
2022-03-25 20:07:54.339919,1843394436,28127,63364,35237,1065.992600
2022-03-25 20:08:04.348979,1844180913,28139,63409,35270,1067.232200
2022-03-25 20:08:14.358440,1844377512,28142,63400,35258,1066.657500
2022-03-25 20:08:24.367817,1845229509,28155,63429,35274,1067.137700
2022-03-25 20:08:34.361878,1844180936,28139,63432,35293,1068.237100
2022-03-25 20:08:44.371208,1843394457,28127,63385,35258,1066.909900
2022-03-25 20:08:54.380757,1843394447,28127,63375,35248,1066.473000
2022-03-25 20:09:04.374836,1844967379,28151,63443,35292,1067.991200
2022-03-25 20:09:14.384332,1845557236,28160,63476,35316,1068.888400
2022-03-25 20:09:24.393981,1847130157,28184,63533,35349,1069.926100
2022-03-25 20:09:34.403493,1846474772,28174,63508,35334,1069.439200
2022-03-25 20:09:44.412950,1848571984,28206,63568,35362,1070.123800
2022-03-25 20:09:54.422475,1850341540,28233,63652,35419,1072.159700
2022-03-25 20:10:04.416940,1850669236,28238,63668,35430,1072.556200
2022-03-25 20:10:14.426318,1850013850,28228,63642,35414,1072.025300
2022-03-25 20:10:24.435486,1848834175,28210,63615,35405,1071.935200
2022-03-25 20:10:34.445167,1848834189,28210,63629,35419,1072.547200
2022-03-25 20:10:44.455084,1850407102,28234,63678,35444,1073.235400
2022-03-25 20:10:54.464570,1849620632,28222,63640,35418,1072.301300
2022-03-25 20:11:04.473802,1850144946,28230,63666,35436,1072.953100
2022-03-25 20:11:14.467765,1850013869,28228,63661,35433,1072.855600
2022-03-25 20:11:24.477287,1850472628,28235,63668,35433,1072.737700
2022-03-25 20:11:34.487113,1848309878,28202,63606,35404,1072.026400
2022-03-25 20:11:44.496348,1850865895,28241,63719,35478,1074.603400
2022-03-25 20:11:54.490355,1853421880,28280,63800,35520,1075.781700
2022-03-25 20:12:04.499895,1852635437,28268,63789,35521,1076.027700
2022-03-25 20:12:14.509520,1852832070,28271,63814,35543,1076.939000
2022-03-25 20:12:24.518961,1854011746,28289,63842,35553,1077.072500
2022-03-25 20:12:34.512890,1851848994,28256,63778,35522,1076.273900
2022-03-25 20:12:44.522515,1853225314,28277,63842,35565,1077.799700
2022-03-25 20:12:54.531841,1854208375,28292,63863,35571,1077.808800
2022-03-25 20:13:04.541501,1852045613,28259,63789,35530,1076.573100
2022-03-25 20:13:14.535792,1854011768,28289,63864,35575,1078.034300
2022-03-25 20:13:24.545003,1854339462,28294,63878,35584,1078.343500
2022-03-25 20:13:34.554718,1854732699,28300,63899,35599,1078.897900
2022-03-25 20:13:44.564235,1854732714,28300,63914,35614,1079.554100
2022-03-25 20:13:54.573696,1853159789,28276,63853,35577,1078.341300
2022-03-25 20:14:04.567723,1853880699,28287,63867,35580,1078.286600
2022-03-25 20:14:14.577026,1852373328,28264,63824,35560,1077.800400
2022-03-25 20:14:24.586721,1852701026,28269,63842,35573,1078.284700
2022-03-25 20:14:34.596106,1855060395,28305,63915,35610,1079.294700
2022-03-25 20:14:44.605788,1856961018,28334,63994,35660,1080.991700
2022-03-25 20:14:54.599787,1856043484,28320,63964,35644,1080.528400
2022-03-25 20:15:04.609406,1857813009,28347,64017,35670,1081.209500
2022-03-25 20:15:14.618895,1857944101,28349,64037,35688,1081.962900
2022-03-25 20:15:24.628604,1858402862,28356,64046,35690,1081.932100
2022-03-25 20:15:34.637862,1857223166,28338,63998,35660,1080.924100
2022-03-25 20:15:44.631939,1855322555,28309,63931,35622,1079.752000
2022-03-25 20:15:54.641559,1855519177,28312,63945,35633,1080.182500
2022-03-25 20:16:04.650973,1854798240,28301,63904,35603,1079.056200
2022-03-25 20:16:14.660480,1858402862,28356,64046,35690,1081.932100
2022-03-25 20:16:24.670024,1860041333,28381,64117,35736,1083.521700
2022-03-25 20:16:34.663984,1860762230,28392,64118,35726,1082.898400
2022-03-25 20:16:44.673415,1858271764,28354,64020,35666,1080.916300
2022-03-25 20:16:54.682903,1856698862,28330,63982,35652,1080.709200
2022-03-25 20:17:04.676946,1852701020,28269,63836,35567,1078.022200
2022-03-25 20:17:14.686414,1852635471,28268,63823,35555,1077.514300
2022-03-25 20:17:24.696056,1854601641,28298,63913,35615,1079.631600
2022-03-25 20:17:34.705415,1850931468,28242,63756,35514,1076.160500
2022-03-25 20:17:44.714974,1849817339,28225,63739,35514,1076.447400
2022-03-25 20:17:54.724600,1850472702,28235,63742,35507,1075.972700
2022-03-25 20:18:04.719571,1849751777,28224,63713,35489,1075.371100
2022-03-25 20:18:14.728619,1849686235,28223,63707,35484,1075.169300
2022-03-25 20:18:24.737716,1849489613,28220,63693,35473,1074.739100
2022-03-25 20:18:34.747273,1848047792,28198,63664,35466,1074.804300
2022-03-25 20:18:44.756705,1847130262,28184,63638,35454,1074.515900
2022-03-25 20:18:54.750886,1846671473,28177,63601,35424,1073.322300
2022-03-25 20:19:04.760415,1846802557,28179,63613,35434,1073.725700
2022-03-25 20:19:14.769845,1846212721,28170,63601,35431,1073.746500
2022-03-25 20:19:24.779445,1847064726,28183,63638,35455,1074.576500
2022-03-25 20:19:34.773444,1847654573,28192,63661,35469,1075.036700
2022-03-25 20:19:44.783117,1848572111,28206,63695,35489,1075.675000
2022-03-25 20:19:54.792465,1847916712,28196,63656,35460,1074.575700
2022-03-25 20:20:04.801930,1847982269,28197,63677,35480,1075.433500
2022-03-25 20:20:14.795892,1849161965,28215,63725,35510,1076.441400
2022-03-25 20:20:24.805313,1849161974,28215,63734,35519,1076.835200
2022-03-25 20:20:34.814923,1850407221,28234,63797,35563,1078.438700
2022-03-25 20:20:44.824284,1850931515,28242,63803,35561,1078.215800
2022-03-25 20:20:54.818343,1852176752,28261,63856,35595,1079.382100
2022-03-25 20:21:04.827780,1852504456,28266,63880,35614,1080.128700
2022-03-25 20:21:14.837216,1854011857,28289,63953,35664,1081.927200
2022-03-25 20:21:24.831203,1855191558,28307,64006,35699,1083.154400
2022-03-25 20:21:34.840655,1855978016,28319,64032,35713,1083.563800
2022-03-25 20:21:44.850286,1857682020,28345,64100,35755,1084.961800
2022-03-25 20:21:54.859848,1858796187,28362,64155,35793,1086.337000
2022-03-25 20:22:04.869389,1860893427,28394,64243,35849,1088.246300
2022-03-25 20:22:14.863907,1861876520,28409,64296,35887,1089.655600
2022-03-25 20:22:24.872914,1864760207,28453,64399,35946,1091.492900
2022-03-25 20:22:34.882339,1864235914,28445,64394,35949,1091.759900
2022-03-25 20:22:44.876357,1865022368,28457,64416,35959,1091.994300
2022-03-25 20:22:54.885738,1866398684,28478,64476,35998,1093.345700
2022-03-25 20:23:04.895164,1867447303,28494,64519,36025,1094.256800
2022-03-25 20:23:14.889166,1866791928,28484,64504,36020,1094.207400
2022-03-25 20:23:24.898673,1869347933,28523,64605,36082,1096.261100
2022-03-25 20:23:34.907990,1869610077,28527,64605,36078,1096.017900
2022-03-25 20:23:44.902137,1871248540,28552,64668,36116,1097.258100
2022-03-25 20:23:54.911511,1873083615,28580,64735,36155,1098.491000
2022-03-25 20:24:04.920838,1873083632,28580,64752,36172,1099.235500
2022-03-25 20:24:14.914978,1874394390,28600,64790,36190,1099.684400
2022-03-25 20:24:24.924147,1874722094,28605,64814,36209,1100.431800
2022-03-25 20:24:34.918046,1874918696,28608,64808,36200,1099.986700
2022-03-25 20:24:44.927458,1875180906,28612,64874,36262,1102.634900
2022-03-25 20:24:54.936974,1874394394,28600,64794,36194,1099.859700
2022-03-25 20:25:04.931012,1873673490,28589,64786,36197,1100.177900
2022-03-25 20:25:14.940549,1870920889,28547,64697,36150,1098.832000
2022-03-25 20:25:24.950272,1872231650,28567,64738,36171,1099.412500
2022-03-25 20:25:34.959464,1871838440,28561,64744,36183,1100.040000
2022-03-25 20:25:44.968928,1871248588,28552,64716,36164,1099.360600
2022-03-25 20:25:54.963215,1872559349,28572,64757,36185,1099.940800
2022-03-25 20:26:04.972750,1872559345,28572,64753,36181,1099.765600
2022-03-25 20:26:14.981804,1871183048,28551,64712,36161,1099.246200
2022-03-25 20:26:24.991266,1870265497,28537,64665,36128,1098.038300
2022-03-25 20:26:35.000834,1869216895,28521,64639,36118,1097.871800
2022-03-25 20:26:45.010651,1867054120,28488,64552,36064,1096.066800
2022-03-25 20:26:55.004636,1866333207,28477,64535,36058,1095.990700
2022-03-25 20:27:05.014178,1864891373,28455,64493,36038,1095.488000
2022-03-25 20:27:15.023849,1864891349,28455,64469,36014,1094.436900
2022-03-25 20:27:25.032970,1864956890,28456,64474,36018,1094.595100
2022-03-25 20:27:35.027067,1862859656,28424,64392,35968,1092.948100
2022-03-25 20:27:45.036603,1860893492,28394,64308,35914,1091.092000
2022-03-25 20:27:55.046102,1858992877,28365,64237,35872,1089.744900
2022-03-25 20:28:05.055475,1859713797,28376,64261,35885,1090.127600
2022-03-25 20:28:15.065088,1856371348,28325,64148,35823,1088.277600
2022-03-25 20:28:25.074583,1853356586,28279,64042,35763,1086.430500
2022-03-25 20:28:35.068617,1852635652,28268,64004,35736,1085.434600
2022-03-25 20:28:45.078049,1850669502,28238,63934,35696,1084.191800
2022-03-25 20:28:55.087490,1852897816,28272,64024,35752,1086.067400
2022-03-25 20:29:05.081403,1847982429,28197,63837,35640,1082.435100
2022-03-25 20:29:15.091413,1844246729,28140,63689,35549,1079.416900
2022-03-25 20:29:25.100348,1843394722,28127,63650,35523,1078.499000
2022-03-25 20:29:35.109826,1842935950,28120,63630,35510,1078.048600
2022-03-25 20:29:45.103919,1841100862,28092,63550,35458,1076.246600
2022-03-25 20:29:55.113367,1840511014,28083,63526,35443,1075.742600
2022-03-25 20:30:05.123000,1844705476,28147,63684,35537,1078.773100
2022-03-25 20:30:15.132275,1837299645,28034,63421,35387,1074.121200
2022-03-25 20:30:25.126221,1838479339,28052,63467,35415,1075.042000
2022-03-25 20:30:35.135593,1833695028,27979,63284,35305,1071.463600
2022-03-25 20:30:45.145186,1832384255,27959,63231,35272,1070.357900
2022-03-25 20:30:55.139219,1830418109,27929,63165,35236,1069.290300
2022-03-25 20:31:05.148467,1829500566,27915,63126,35211,1068.433200
2022-03-25 20:31:15.157916,1837758391,28041,63415,35374,1073.433700
2022-03-25 20:31:25.167421,1830418118,27929,63174,35245,1069.684100
2022-03-25 20:31:35.176987,1827796554,27889,63050,35161,1066.685100
2022-03-25 20:31:45.171015,1828255343,27896,63087,35191,1067.879400
2022-03-25 20:31:55.180328,1827534383,27885,63023,35138,1065.746300
2022-03-25 20:32:05.174326,1826092547,27863,62979,35116,1065.156000
2022-03-25 20:32:15.183640,1825175007,27849,62943,35094,1064.430300
2022-03-25 20:32:25.193008,1825043929,27847,62937,35090,1064.289100
2022-03-25 20:32:35.202460,1824323013,27836,62917,35081,1064.081300
2022-03-25 20:32:45.196426,1825502716,27854,62972,35118,1065.395800
2022-03-25 20:32:55.205910,1826223625,27865,62985,35120,1065.297200
2022-03-25 20:33:05.215243,1826420233,27868,62985,35117,1065.115100
2022-03-25 20:33:15.224653,1826223635,27865,62995,35130,1065.734700
2022-03-25 20:33:25.218578,1825961467,27861,62971,35110,1064.927200
2022-03-25 20:33:35.227927,1825764849,27858,62961,35103,1064.671900
2022-03-25 20:33:45.221919,1824519636,27839,62932,35093,1064.555700
2022-03-25 20:33:55.231350,1822815626,27813,62858,35045,1062.895300
2022-03-25 20:34:05.240663,1824191933,27834,62909,35075,1063.852700
2022-03-25 20:34:15.250244,1825437179,27853,62971,35118,1065.412600
2022-03-25 20:34:25.244336,1829303979,27912,63147,35235,1069.534400
2022-03-25 20:34:35.253742,1827534398,27885,63038,35153,1066.402800
2022-03-25 20:34:45.263174,1824454089,27838,62921,35083,1064.135000
2022-03-25 20:34:55.272524,1822815636,27813,62868,35055,1063.332800
2022-03-25 20:35:05.266688,1822094677,27802,62805,35003,1061.243900
2022-03-25 20:35:15.276086,1825175005,27849,62941,35092,1064.342800
2022-03-25 20:35:25.285511,1824912860,27845,62940,35095,1064.541700
2022-03-25 20:35:35.295040,1826616862,27871,63006,35135,1065.852100
2022-03-25 20:35:45.304605,1825961485,27861,62989,35128,1065.715000
2022-03-25 20:35:55.298680,1826289167,27866,62991,35125,1065.499000
2022-03-25 20:36:05.308244,1825633772,27856,62956,35100,1064.574500
2022-03-25 20:36:15.317608,1825830377,27859,62953,35094,1064.261200
2022-03-25 20:36:25.327299,1825568236,27855,62956,35101,1064.635100
2022-03-25 20:36:35.336667,1824454097,27838,62929,35091,1064.485100
2022-03-25 20:36:45.346152,1824650701,27841,62925,35084,1064.127900
2022-03-25 20:36:55.340294,1824388543,27837,62911,35074,1063.758200
2022-03-25 20:37:05.349744,1823405470,27822,62878,35056,1063.224400
2022-03-25 20:37:15.359261,1823864242,27829,62898,35069,1063.674800
2022-03-25 20:37:25.368816,1824060851,27832,62899,35067,1063.536600
2022-03-25 20:37:35.378189,1824257468,27835,62908,35073,1063.748300
2022-03-25 20:37:45.372117,1824322993,27836,62897,35061,1063.206300
2022-03-25 20:37:55.381662,1824126389,27833,62901,35068,1063.563200
2022-03-25 20:38:05.391094,1826289156,27866,62980,35114,1065.017800
2022-03-25 20:38:15.384874,1826485766,27869,62982,35113,1064.923200
2022-03-25 20:38:25.394535,1825830392,27859,62968,35109,1064.917400
2022-03-25 20:38:35.404054,1825764864,27858,62976,35118,1065.328100
2022-03-25 20:38:45.413544,1824454081,27838,62913,35075,1063.785200
2022-03-25 20:38:55.407424,1821439297,27792,62785,34993,1060.975500
2022-03-25 20:39:05.416802,1829172832,27910,63072,35162,1066.373800
2022-03-25 20:39:15.426294,1829500507,27915,63067,35152,1065.851800
2022-03-25 20:39:25.420340,1829303920,27912,63088,35176,1066.952300
2022-03-25 20:39:35.429709,1828845150,27905,63070,35165,1066.589500
2022-03-25 20:39:45.439067,1828845143,27905,63063,35158,1066.283200
2022-03-25 20:39:55.433120,1828451902,27899,63038,35139,1065.553500
2022-03-25 20:40:05.443035,1827862052,27890,63012,35122,1064.962000
2022-03-25 20:40:15.451923,1827665438,27887,63006,35119,1064.881500
2022-03-25 20:40:25.461291,1827796512,27889,63008,35119,1064.847700
2022-03-25 20:40:35.470822,1827599904,27886,63008,35122,1065.029700
2022-03-25 20:40:45.464910,1827927592,27891,63016,35125,1065.076300
2022-03-25 20:40:55.474480,1826813436,27874,62972,35098,1064.182700
2022-03-25 20:41:05.483753,1827206662,27880,62982,35102,1064.256100
2022-03-25 20:41:15.478230,1825961437,27861,62941,35080,1063.615000
2022-03-25 20:41:25.487261,1826878956,27875,62956,35081,1063.422200
2022-03-25 20:41:35.496745,1826026938,27862,62906,35044,1062.023600
2022-03-25 20:41:45.506319,1825502642,27854,62898,35044,1062.158700
2022-03-25 20:41:55.515724,1824060809,27832,62857,35025,1061.699300
2022-03-25 20:42:05.525262,1822356791,27806,62775,34969,1059.689500
2022-03-25 20:42:15.519235,1822815534,27813,62766,34953,1058.871900
2022-03-25 20:42:25.528900,1823208741,27819,62757,34938,1058.114900
2022-03-25 20:42:35.538168,1822881068,27814,62764,34950,1058.723800
2022-03-25 20:42:45.547679,1823274281,27820,62761,34941,1058.229100
2022-03-25 20:42:55.541511,1822291206,27805,62726,34921,1057.607800
2022-03-25 20:43:05.550925,1823274316,27820,62796,34976,1059.759300
2022-03-25 20:43:15.560460,1821897980,27799,62716,34917,1057.534200
2022-03-25 20:43:25.569901,1819866294,27768,62646,34878,1056.352100
2022-03-25 20:43:35.579628,1820718281,27781,62665,34884,1056.395100
2022-03-25 20:43:45.589069,1820718298,27781,62682,34901,1057.138300
2022-03-25 20:43:55.583010,1820718277,27781,62661,34880,1056.220500
2022-03-25 20:44:05.592692,1821373675,27791,62699,34908,1057.275600
2022-03-25 20:44:15.601997,1823470877,27823,62749,34926,1057.523100
2022-03-25 20:44:25.611501,1823208730,27819,62746,34927,1057.634200
2022-03-25 20:44:35.621093,1823405363,27822,62771,34949,1058.545000
2022-03-25 20:44:45.614978,1824126332,27833,62844,35011,1061.070200
